00000000000000000000
00000000000000000000
00000000000000000000
00000000000000000000
00000000000000000000
00000000000000000000
00000011100000000000
00000014100000000000
00000012111100000000
00001113324100000000
00001435211100000000
00001111310000000000
00000001410000000000
00000001110000000000
00000000000000000000
00000000000000000000
00000000000000000000
00000000000000000000
00000000000000000000
00000000000000000000