00000000000000000000
00000000000000000000
00000000000000000000
00000001111110000000
00000001222210000000
00000001221211100000
00000001232322110000
00000001222322210000
00000001133333210000
00000000122221210000
00000000111223210000
00000000001232210000
00000001111311110000
00000001242224210000
00000001242524210000
00000001444444410000
00000001111111110000
00000000000000000000
00000000000000000000
00000000000000000000