00000000000000000000
00000000000000000000
00001111111111111100
00001222221222222100
00001233322223332100
00001122233332221100
00000132322223231000
00000122233332221000
00000133322223331000
00000123233332321000
00000122222222221000
00001111114411111100
00001449499994944100
00001449444444944100
00001149999999941100
00000144444444441000
00000111111511111000
00000000001110000000
00000000000000000000
00000000000000000000